WWWWWWWWWWWWWWWWWWWWWWWWWWWWWWWWWW
WWWWWWWWWWWWWWWWWWWWWWWWWWWWWWWWWW
WWFFFFFFFFFFFFFFFFFFFFFFFFFFFFFFWW
WWFFFFFFFFFFFFFFFFFFFFFFFFFFFFFFWW
WWFFFFFFFFRFFFFFFFFFFFFFFFFEFFFFWW
WWFFFFFFFFFFFFFFFFFFFFFFFFFFFFFFWW
WWFFFFFFFFFFFFFFFBFFFFFFFFFFFFFFWW
WWFFFFFFFFFFFFFFFFFFFFFFFFFFFFFFWW
WWFFFFFFFFFFFFFFFFFFFFFFFFFFFFFFWW
WWFFFRFFFFFFFFFFFFFFFFFFFFWWFFFFWW
WWFFFFFFFFFFFFFFFFFFFFFFFFFFFFFFWW
WWFFFFFFFFFFFFFFFFFFFFFFFFFFFFFFWW
WWFFFFFFWFFFFFFFFFFFFFFFFFFFFFFFWW
WWFFFFFFFFFFFFFFFFFFFFFFFFFFFFFFWW
WWFFFFFFFFFFFFFFFFFFFFFFFFFFFFFFWW
WWFFFFFFFFFFFFFFFFFFFWWFFFFFEFFFWW
WWFWWFFFFFFFFFFFFFFFFFFFFFFFFFFFWW
WWFFFFFFFFFFFFFFFFFFFFFFFFFFFFFFWW
WWFFFFFFFFFFFFFFFFFFFFFFFFFFFFFFWW
WWFFFFFFFFFFFFFFFFFFFFFFFFFFFFFFWW
WWFFFFFFFFFFFFFFFFFFFFFFFFFFFFFFWW
WWFFFFFFFWFWFFFFFFFFFFFFFWFWFFFFWW
WWFFFFFFFFFFFFFFFFFFFFFFFFFFFFFFWW
WWFFFFRFFFFFFFFFFFFFFFFFFFFFFFFFWW
WWFFFFFFFFFFFFFFFFFFFFFFFFFFFFFFWW
WWFFFFFFFFFFFFFFFFFFFFFFFFFFFFFFWW
WWFFFFFFFFFFFFFFFFFFFFFFFFFFFFFFWW
WWFFFFFFFFFFWFFFFFFFWFFFFFFFFFFFWW
WWFFFFFFFFFFWFFFFFFFWFFFFFFFFFFFWW
WWFFFFFFFFFFWFFFPFFFWFFFFFFFEFFFWW
WWFFFFFFFFFFFFFFFFFFFFFFFFFFFFFFWW
WWFFFFFFFFFFFFFFFFFFFFFFFFFFFFFFWW
WWWWWWWWWWWWWWWWWWWWWWWWWWWWWWWWWW
WWWWWWWWWWWWWWWWWWWWWWWWWWWWWWWWWW
