WWWWWWWWWWWWWWWWWWWWWWWWWWWWWWWWWW
WWWWWWWWWWWWWWWWWWWWWWWWWWWWWWWWWW
WWFFFFFFFFFFFFFCFFFFFFFFFFFFFFFFWW
WWFFFFPFFFFFFFFCFFFFFFFFFFFFFFFFWW
WWFFFFFFFFFFFFFWFFFFFFFFFFFFFFFFWW
WWWWWWWWWWWWWWWWWFFFWWWWWWWWFFFFWW
WWFFFFFFFFFFFFFWFFFFFFFWFFFFFFFFWW
WWFFFFFFFFFFFFFCFFFFFFFFFFFFFFFFWW
WWFFFFFFFFFFFFFCFFFFFFFFWFFFFFFFWW
WWFFMFFFFFFFAFFCFFFFFFFFFFFFFFFFWW
WWFFFFFFFFFFFFFWFFFFFFFWFFFFFFFFWW
WWFFFFWWWWWFFFWWFFFFFFFFFFFTFFFFWW
WWFFFFFFFFFFFFFWFFFFFFFFWFFFFFFFWW
WWFFFFFFFFFFFFFWWFFFWWWWWWWWFFFFWW
WWFFFFFFFFFFFFWFFFFFFFFFFFFFFFFFWW
WWFFFFFFFFFFFWFFFFFFFFFFFFFFFFFFWW
WWFFFFAFFFFFFFFFAFFFFFFFFFFFFFFFWW
WWFFFFFFFFFFFFFFFFFFFFFFFFFFFFFFWW
WWFFFFWWWFFFWWWFFFFWWWFFFWWWFFFFWW
WWFFFWFFFFFFFFFFFFFFFFFFFFFFWFFFWW
WWFFFWFFFEFFFFFFFRFFFFFFEFFFWFFFWW
WWFFFWFFFFFFFFFFFFFFFFFFFFFFWFFFWW
WWFFFFFFFWFFFFFWWWWFFFFFWFFFFFFFWW
WWFFTFFFFFFFFFFFFFFFFFFFFFFFFFFFWW
WWFFFFFFFWFFFFFWWWWFFFFFWFFFFFFFWW
WWFFFWFFFFFFFFFFFFFFFFFFFFFFWFFFWW
WWFFFWFFFTFFFFFFRFFFFFFFTFFFWFFFWW
WWFFFWFFFFFFFFFFFFFFFFFFFFFFWFFFWW
WWFFFFWWWFFFWWWFFFFWWWFFFWWWFFFFWW
WWFFAFFFFFFFFFFFFFFFFFFFFFFFFEFFWW
WWFFFFFFFFFFFFFFFFFFFFFFFFFFFFFFWW
WWFFFFFFFFFFFFFFFFFFFFFFFFFFFFFFWW
WWWWWWWWWWWWWWWWWWWWWWWWWWWWWWWWWW
WWWWWWWWWWWWWWWWWWWWWWWWWWWWWWWWWW
