WWWWWWWWWWWWWWWWWWWWWWWWWWWWWWWWWW
WWWWWWWWWWWWWWWWWWWWWWWWWWWWWWWWWW
WWFFFFFFFFFFFFFFFFFFFFFFFFFFFFFFWW
WWFFFFFFFFFFFFFFFFFFFFFFFFFFFFFFWW
WWFFEFFFFFFFFFFFFFFFFFFFFFFFFAFFWW
WWFFFFWWWFFFWWWFFFFWWWFFFWWWFFFFWW
WWFFFWFFFFFFFFFFFFFFFFFFFFFFWFFFWW
WWFFFWFFFTFFFFFFFRFFFFFFTFFFWFFFWW
WWFFFWFFFFFFFFFFFFFFFFFFFFFFWFFFWW
WWFFFFFFFWFFFFFWWWWFFFFFWFFFFFFFWW
WWFFFFFFFFFFFFFFFFFFFFFFFFFFFTFFWW
WWFFFFFFFWFFFFFWWWWFFFFFWFFFFFFFWW
WWFFFWFFFFFFFFFFFFFFFFFFFFFFWFFFWW
WWFFFWFFFEFFFFFFRFFFFFFFEFFFWFFFWW
WWFFFWFFFFFFFFFFFFFFFFFFFFFFWFFFWW
WWFFFFWWWFFFWWWFFFFWWWFFFWWWFFFFWW
WWFFFFFFFFFFFFFFFFFFFFFFFFFFFFFFWW
WWFFFFFFFFFFFFFFFAFFFFFFFFFAFFFFWW
WWFFFFFFFFFFFFFFFFFFWFFFFFFFFFFFWW
WWFFFFFFFFFFFFFFFFFWFFFFFFFFFFFFWW
WWFFFFWWWWWWWWFFFWWFFFFFFFFFFFFFWW
WWFFFFFFFWFFFFFFFFWFFFFFFFFFFFFFWW
WWFFFFTFFFFFFFFFFFWWFFFWWWWWFFFFWW
WWFFFFFFFFWFFFFFFFWFFFFFFFFFFFFFWW
WWFFFFFFFFFFFFFFFFCFFAFFFFFFFMFFWW
WWFFFFFFFWFFFFFFFFCFFFFFFFFFFFFFWW
WWFFFFFFFFFFFFFFFFCFFFFFFFFFFFFFWW
WWFFFFFFFFWFFFFFFFWFFFFFFFFFFFFFWW
WWFFFFWWWWWWWWFFFWWWWWWWWWWWWWWWWW
WWFFFFFFFFFFFFFFFFWFFFFFFFFFFFFFWW
WWFFFFFFFFFFFFFFFFCFFFFFFFFPFFFFWW
WWFFFFFFFFFFFFFFFFCFFFFFFFFFFFFFWW
WWWWWWWWWWWWWWWWWWWWWWWWWWWWWWWWWW
WWWWWWWWWWWWWWWWWWWWWWWWWWWWWWWWWW
