WWWWWWWWWWWWWWWWWWWWWWWWWWWWWWWWWW
WWWWWWWWWWWWWWWWWWWWWWWWWWWWWWWWWW
WWFFFFFFFFFFFFFFFFCFFFFFFFFFFFFFWW
WWFFFFFFFFFFFFFFFFCFFFFFFFFPFFFFWW
WWFFFFFFFFFFFFFFFFWFFFFFFFFFFFFFWW
WWFFFFWWWWWWWWFFFWWWWWWWWWWWWWWWWW
WWFFFFFFFFWFFFFFFFWFFFFFFFFFFFFFWW
WWFFFFFFFFFFFFFFFFCFFFFFFFFFFFFFWW
WWFFFFFFFWFFFFFFFFCFFFFFFFFFFFFFWW
WWFFFFFFFFFFFFFFFFCFFAFFFFFFFMFFWW
WWFFFFFFFFWFFFFFFFWFFFFFFFFFFFFFWW
WWFFFFTFFFFFFFFFFFWWFFFWWWWWFFFFWW
WWFFFFFFFWFFFFFFFFWFFFFFFFFFFFFFWW
WWFFFFWWWWWWWWFFFWWFFFFFFFFFFFFFWW
WWFFFFFFFFFFFFFFFFFWFFFFFFFFFFFFWW
WWFFFFFFFFFFFFFFFFFFWFFFFFFFFFFFWW
WWFFFFFFFFFFFFFFFAFFFFFFFFFAFFFFWW
WWFFFFFFFFFFFFFFFFFFFFFFFFFFFFFFWW
WWFFFFWWWFFFWWWFFFFWWWFFFWWWFFFFWW
WWFFFWFFFFFFFFFFFFFFFFFFFFFFWFFFWW
WWFFFWFFFEFFFFFFRFFFFFFFEFFFWFFFWW
WWFFFWFFFFFFFFFFFFFFFFFFFFFFWFFFWW
WWFFFFFFFWFFFFFWWWWFFFFFWFFFFFFFWW
WWFFFFFFFFFFFFFFFFFFFFFFFFFFFTFFWW
WWFFFFFFFWFFFFFWWWWFFFFFWFFFFFFFWW
WWFFFWFFFFFFFFFFFFFFFFFFFFFFWFFFWW
WWFFFWFFFTFFFFFFFRFFFFFFTFFFWFFFWW
WWFFFWFFFFFFFFFFFFFFFFFFFFFFWFFFWW
WWFFFFWWWFFFWWWFFFFWWWFFFWWWFFFFWW
WWFFEFFFFFFFFFFFFFFFFFFFFFFFFAFFWW
WWFFFFFFFFFFFFFFFFFFFFFFFFFFFFFFWW
WWFFFFFFFFFFFFFFFFFFFFFFFFFFFFFFWW
WWWWWWWWWWWWWWWWWWWWWWWWWWWWWWWWWW
WWWWWWWWWWWWWWWWWWWWWWWWWWWWWWWWWW
