WWWWWWWWWWWWWWWWWWWWWWWWWWWWWWWWWW
WWWWWWWWWWWWWWWWWWWWWWWWWWWWWWWWWW
WWFFFFFFFFFFFFFFFFFFFFFFFFFFFFFFWW
WWFFFFFFFFFFFFFFFFFFFFFFFFFFFFFFWW
WWFFAFFFFFFFFFFFFFFFFFFFFFFFFEFFWW
WWFFFFWWWFFFWWWFFFFWWWFFFWWWFFFFWW
WWFFFWFFFFFFFFFFFFFFFFFFFFFFWFFFWW
WWFFFWFFFTFFFFFFRFFFFFFFTFFFWFFFWW
WWFFFWFFFFFFFFFFFFFFFFFFFFFFWFFFWW
WWFFFFFFFWFFFFFWWWWFFFFFWFFFFFFFWW
WWFFTFFFFFFFFFFFFFFFFFFFFFFFFFFFWW
WWFFFFFFFWFFFFFWWWWFFFFFWFFFFFFFWW
WWFFFWFFFFFFFFFFFFFFFFFFFFFFWFFFWW
WWFFFWFFFEFFFFFFFRFFFFFFEFFFWFFFWW
WWFFFWFFFFFFFFFFFFFFFFFFFFFFWFFFWW
WWFFFFWWWFFFWWWFFFFWWWFFFWWWFFFFWW
WWFFFFFFFFFFFFFFFFFFFFFFFFFFFFFFWW
WWFFFFAFFFFFFFFFAFFFFFFFFFFFFFFFWW
WWFFFFFFFFFFFWFFFFFFFFFFFFFFFFFFWW
WWFFFFFFFFFFFFWFFFFFFFFFFFFFFFFFWW
WWFFFFFFFFFFFFFWWFFFWWWWWWWWFFFFWW
WWFFFFFFFFFFFFFWFFFFFFFFWFFFFFFFWW
WWFFFFWWWWWFFFWWFFFFFFFFFFFTFFFFWW
WWFFFFFFFFFFFFFWFFFFFFFWFFFFFFFFWW
WWFFMFFFFFFFAFFCFFFFFFFFFFFFFFFFWW
WWFFFFFFFFFFFFFCFFFFFFFFWFFFFFFFWW
WWFFFFFFFFFFFFFCFFFFFFFFFFFFFFFFWW
WWFFFFFFFFFFFFFWFFFFFFFWFFFFFFFFWW
WWWWWWWWWWWWWWWWWFFFWWWWWWWWFFFFWW
WWFFFFFFFFFFFFFWFFFFFFFFFFFFFFFFWW
WWFFFFPFFFFFFFFCFFFFFFFFFFFFFFFFWW
WWFFFFFFFFFFFFFCFFFFFFFFFFFFFFFFWW
WWWWWWWWWWWWWWWWWWWWWWWWWWWWWWWWWW
WWWWWWWWWWWWWWWWWWWWWWWWWWWWWWWWWW
