WWWWWWWWWWWWWWWWWWWWWWWWWWWWWWWWWW
WWWWWWWWWWWWWWWWWWWWWWWWWWWWWWWWWW
WWFFFFFFFFEFFFFFFFFFFFFFFFFFFFFFWW
WWFFFFFFFFFFFFFFFFFFFFFFFFFFFMFFWW
WWWFFFWWWFFFWWWWWWWWWWFFFWWWFFFWWW
WWFFFFFFFFFFFFFFWWFFFFFFFFFFFFFFWW
WWFFFFFFFFFFFFTFWWFFFFFFFFFFFFFFWW
WWFFFFFFFFFFFFFFWWFFFFFFFFFFFFFFWW
WWWWWWFFFWWWFFFWWWWFFFWWWFFFWWWWWW
WWFFFFFFFFFFFFFFWWFFFFFFFFFFFFFFWW
WWFFEFFFFFFFFFFFWWFFEFFFFFFFFFFFWW
WWFFFFFFFFFFFFFFWWFFFFFFFFFFFFFFWW
WWWFFFWWWFFFWWWWWWWWWWFFFWWWFFFWWW
WWFFFFFFFFFFFFFFWWFFFFFFFFFFFFFFWW
WWFFFFFFFFFFFTFFFFFFFFFFFFFFFFFFWW
WWFFFFFFFFFFFFFFWWFFFFFFFFFFFFFFWW
WWWWWWFFFWWWFFFWWWWFFFWWWFFFWWWWWW
WWFFFFFFFFFFFFFFWWFFFFFFFFFFFFFFWW
WWFFFFFFFFFFFFFFWWFFFFFFFFFFFFFFWW
WWFFFFFFFFFFFFFFWWFFFFFFFFFFFFFFWW
WWWFFFWWWFFFWWWWWWWWWWFFFWWWFFFWWW
WWFFFFFFFFFFFFFFWWFFFFFFFFFFFFFFWW
WWFFFFFFFFFTFFFFWWFFFRFFFFFFFEFFWW
WWFFFFFFFFFFFFFFWWFFFFFFFFFFFFFFWW
WWWWWWFFFWWWFFFWWWWFFFWWWFFFWWWWWW
WWFFFFFFFFFFFFFFWWFFFFFFFFFFFFFFWW
WWFFFFFFFFFFFFFFWWFFFFFFFFFFFTFFWW
WWFFFFFFFFFFFFFFWWFFFFFFFFFFFFFFWW
WWWWWWFFFWWWWWWWWWWWWWWWWFFFWWWWWW
WWFFFFFFFFFFFFFFWWFFFFFFFFFFFFFFWW
WWFFFFFFFFFFPFFFWWFFEFFFFFFRFFFFWW
WWFFFFFFFFFFFFFFWWFFFFFFFFFFFFFFWW
WWWWWWWWWWWWWWWWWWWWWWWWWWWWWWWWWW
WWWWWWWWWWWWWWWWWWWWWWWWWWWWWWWWWW
