WWWWWWWWWWWWWWWWWWWWWWWWWWWWWWWWWW
WWWWWWWWWWWWWWWWWWWWWWWWWWWWWWWWWW
WWFFFFFFFFFFFFFFWWFFFFFFFFFFFFFFWW
WWFFFFRFFFFFFEFFWWFFFPFFFFFFFFFFWW
WWFFFFFFFFFFFFFFWWFFFFFFFFFFFFFFWW
WWWWWWFFFWWWWWWWWWWWWWWWWFFFWWWWWW
WWFFFFFFFFFFFFFFWWFFFFFFFFFFFFFFWW
WWFFTFFFFFFFFFFFWWFFFFFFFFFFFFFFWW
WWFFFFFFFFFFFFFFWWFFFFFFFFFFFFFFWW
WWWWWWFFFWWWFFFWWWWFFFWWWFFFWWWWWW
WWFFFFFFFFFFFFFFWWFFFFFFFFFFFFFFWW
WWFFEFFFFFFFRFFFWWFFFFTFFFFFFFFFWW
WWFFFFFFFFFFFFFFWWFFFFFFFFFFFFFFWW
WWWFFFWWWFFFWWWWWWWWWWFFFWWWFFFWWW
WWFFFFFFFFFFFFFFWWFFFFFFFFFFFFFFWW
WWFFFFFFFFFFFFFFWWFFFFFFFFFFFFFFWW
WWFFFFFFFFFFFFFFWWFFFFFFFFFFFFFFWW
WWWWWWFFFWWWFFFWWWWFFFWWWFFFWWWWWW
WWFFFFFFFFFFFFFFWWFFFFFFFFFFFFFFWW
WWFFFFFFFFFFFFFFFFFFTFFFFFFFFFFFWW
WWFFFFFFFFFFFFFFWWFFFFFFFFFFFFFFWW
WWWFFFWWWFFFWWWWWWWWWWFFFWWWFFFWWW
WWFFFFFFFFFFFFFFWWFFFFFFFFFFFFFFWW
WWFFFFFFFFFFFEFFWWFFFFFFFFFFFEFFWW
WWFFFFFFFFFFFFFFWWFFFFFFFFFFFFFFWW
WWWWWWFFFWWWFFFWWWWFFFWWWFFFWWWWWW
WWFFFFFFFFFFFFFFWWFFFFFFFFFFFFFFWW
WWFFFFFFFFFFFFFFWWFTFFFFFFFFFFFFWW
WWFFFFFFFFFFFFFFWWFFFFFFFFFFFFFFWW
WWWFFFWWWFFFWWWWWWWWWWFFFWWWFFFWWW
WWFFMFFFFFFFFFFFFFFFFFFFFFFFFFFFWW
WWFFFFFFFFFFFFFFFFFFFFFEFFFFFFFFWW
WWWWWWWWWWWWWWWWWWWWWWWWWWWWWWWWWW
WWWWWWWWWWWWWWWWWWWWWWWWWWWWWWWWWW