WWWWWWWWWWWWWWWWWWWWWWWWWWWWWWWWWW
WWWWWWWWWWWWWWWWWWWWWWWWWWWWWWWWWW
WWFFFFFFFFFFFFFFFFFFFFFFFFFFFFFFWW
WWFFFPFFFFFFFFFFFFFFFFFFFFFFFFFFWW
WWFFFFFFFFFFFWFFFFFFFFFFWFFFFFFFWW
WWWWWWWWWWWWWWFFFFFFFFFFWWWWWFFFWW
WWFFFFFFFFFFFFFFFFFFFFFFFFFFFFFFWW
WWFFTFFFFFFFFFFFFFFFFFFFFFFFFFFFWW
WWFFFFFFFFFEFFFFFFFFFFFFFFFFFFFFWW
WWFFFFFFFFFFFFFFFFFFFFFFFFFFFFFFWW
WWFFFFFFFWWWWWWWWWWFFFFFFWWWWWWWWW
WWFFFFFFFWFFFFFFFFFFFFFFFFFFFFFFWW
WWFFFEFFFWFFFFFFFFFFFFFFFFFFFRFFWW
WWFFFFFFFWFTFFFFFFFFFFFFFFFFFFFFWW
WWFFFFFFFWFFFFFFFFFFFFFFFFFFFFFFWW
WWWWFFFWWWWWWWWWWWWFFFFFFFWWWWWWWW
WWFFFFFFFFFFFFFFFFFFFFFFFFFFFFFFWW
WWFFFFFFRFFFFFFFFFFFFFFFFFFFFFTFWW
WWFFFFFFFFFFFFFFFFFFFFFFFFFFFFFFWW
WWWWWWFFFWWWWWWWWWWWWWWWWWWWFFFWWW
WWFFFFFFFFFFFFWFFFFFFFFFFFFFFFFFWW
WWFFFFFFFFFFFFWFFFFEFFFFFFFFTFFFWW
WWFFFFFFFFFFFFWFFFFFFFFFFFFFFFFFWW
WWFFFFFFFFFFFFWFFFFFFFFFFAFFFFFFWW
WWFFFFFFFFFFFFWFFFFFFFFFFFFFFFFFWW
WWFFFFFFFFFFFFWFFFFFFFFFFFFFFFFFWW
WWFFFFFFAFFFFFFFFFFFFFFFFFFFFFFFWW
WWFFFFFFFFFFFFFFFFFFFFFFTFFFFFFFWW
WWFFFFFFFFFFFFFFFFFFFFFFFFFFFFFFWW
WWFFFFFFFFFFFFWFFFFFFFFFFFFFFFFFWW
WWFFMFFFFFFFFFWFFFTFFFFFFFFFMFFFWW
WWFFFFFFFFFFFFWFFFFFFFFFFFFFFFFFWW
WWWWWWWWWWWWWWWWWWWWWWWWWWWWWWWWWW
WWWWWWWWWWWWWWWWWWWWWWWWWWWWWWWWWW
