WWWWWWWWWWWWWWWWWWWWWWWWWWWWWWWWWW
WWWWWWWWWWWWWWWWWWWWWWWWWWWWWWWWWW
WWFFFFFFFFFFFFWFFFFFFFFFFFFFFFFFWW
WWFFMFFFFFFFFFWFFFTFFFFFFFFFMFFFWW
WWFFFFFFFFFFFFWFFFFFFFFFFFFFFFFFWW
WWFFFFFFFFFFFFFFFFFFFFFFFFFFFFFFWW
WWFFFFFFFFFFFFFFFFFFFFFFTFFFFFFFWW
WWFFFFFFAFFFFFFFFFFFFFFFFFFFFFFFWW
WWFFFFFFFFFFFFWFFFFFFFFFFFFFFFFFWW
WWFFFFFFFFFFFFWFFFFFFFFFFFFFFFFFWW
WWFFFFFFFFFFFFWFFFFFFFFFFAFFFFFFWW
WWFFFFFFFFFFFFWFFFFFFFFFFFFFFFFFWW
WWFFFFFFFFFFFFWFFFFEFFFFFFFFTFFFWW
WWFFFFFFFFFFFFWFFFFFFFFFFFFFFFFFWW
WWWWWWFFFWWWWWWWWWWWWWWWWWWWFFFWWW
WWFFFFFFFFFFFFFFFFFFFFFFFFFFFFFFWW
WWFFFFFFRFFFFFFFFFFFFFFFFFFFFFTFWW
WWFFFFFFFFFFFFFFFFFFFFFFFFFFFFFFWW
WWWWFFFWWWWWWWWWWWWFFFFFFFWWWWWWWW
WWFFFFFFFWFFFFFFFFFFFFFFFFFFFFFFWW
WWFFFFFFFWFTFFFFFFFFFFFFFFFFFFFFWW
WWFFFEFFFWFFFFFFFFFFFFFFFFFFFRFFWW
WWFFFFFFFWFFFFFFFFFFFFFFFFFFFFFFWW
WWFFFFFFFWWWWWWWWWWFFFFFFWWWWWWWWW
WWFFFFFFFFFFFFFFFFFFFFFFFFFFFFFFWW
WWFFFFFFFFFEFFFFFFFFFFFFFFFFFFFFWW
WWFFTFFFFFFFFFFFFFFFFFFFFFFFFFFFWW
WWFFFFFFFFFFFFFFFFFFFFFFFFFFFFFFWW
WWWWWWWWWWWWWWFFFFFFFFFFWWWWWFFFWW
WWFFFFFFFFFFFWFFFFFFFFFFWFFFFFFFWW
WWFFFPFFFFFFFFFFFFFFFFFFFFFFFFFFWW
WWFFFFFFFFFFFFFFFFFFFFFFFFFFFFFFWW
WWWWWWWWWWWWWWWWWWWWWWWWWWWWWWWWWW
WWWWWWWWWWWWWWWWWWWWWWWWWWWWWWWWWW
