WWWWWWWWWWWWWWWWWWWWWWWWWWWWWWWWWW
WWWWWWWWWWWWWWWWWWWWWWWWWWWWWWWWWW
WWFFFFFFFFFFFFFFFFFFFFFFFFFFFFFFWW
WWFFFFFFFFFFFFFFFFFFFFFFFFFFPFFFWW
WWFFFFFFFWFFFFFFFFFFWFFFFFFFFFFFWW
WWFFFWWWWWFFFFFFFFFFWWWWWWWWWWWWWW
WWFFFFFFFFFFFFFFFFFFFFFFFFFFFFFFWW
WWFFFFFFFFFFFFFFFFFFFFFFFFFFFTFFWW
WWFFFFFFFFFFFFFFFFFFFFEFFFFFFFFFWW
WWFFFFFFFFFFFFFFFFFFFFFFFFFFFFFFWW
WWWWWWWWWFFFFFFWWWWWWWWWWFFFFFFFWW
WWFFFFFFFFFFFFFFFFFFFFFFWFFFFFFFWW
WWFFRFFFFFFFFFFFFFFFFFFFWFFFEFFFWW
WWFFFFFFFFFFFFFFFFFFFFTFWFFFFFFFWW
WWFFFFFFFFFFFFFFFFFFFFFFWFFFFFFFWW
WWWWWWWWFFFFFFFWWWWWWWWWWWWFFFWWWW
WWFFFFFFFFFFFFFFFFFFFFFFFFFFFFFFWW
WWFTFFFFFFFFFFFFFFFFFFFFFRFFFFFFWW
WWFFFFFFFFFFFFFFFFFFFFFFFFFFFFFFWW
WWWFFFWWWWWWWWWWWWWWWWWWWFFFWWWWWW
WWFFFFFFFFFFFFFFFFFWFFFFFFFFFFFFWW
WWFFFTFFFFFFFFEFFFFWFFFFFFFFFFFFWW
WWFFFFFFFFFFFFFFFFFWFFFFFFFFFFFFWW
WWFFFFFFAFFFFFFFFFFWFFFFFFFFFFFFWW
WWFFFFFFFFFFFFFFFFFWFFFFFFFFFFFFWW
WWFFFFFFFFFFFFFFFFFWFFFFFFFFFFFFWW
WWFFFFFFFFFFFFFFFFFFFFFFFAFFFFFFWW
WWFFFFFFFTFFFFFFFFFFFFFFFFFFFFFFWW
WWFFFFFFFFFFFFFFFFFFFFFFFFFFFFFFWW
WWFFFFFFFFFFFFFFFFFWFFFFFFFFFFFFWW
WWFFFMFFFFFFFFFTFFFWFFFFFFFFFMFFWW
WWFFFFFFFFFFFFFFFFFWFFFFFFFFFFFFWW
WWWWWWWWWWWWWWWWWWWWWWWWWWWWWWWWWW
WWWWWWWWWWWWWWWWWWWWWWWWWWWWWWWWWW
