WWWWWWWWWWWWWWWWWWWWWWWWWWWWWWWWWW
WWWWWWWWWWWWWWWWWWWWWWWWWWWWWWWWWW
WWFFFFFFFFFFFFFFFFFWFFFFFFFFFFFFWW
WWFFFMFFFFFFFFFTFFFWFFFFFFFFFMFFWW
WWFFFFFFFFFFFFFFFFFWFFFFFFFFFFFFWW
WWFFFFFFFFFFFFFFFFFFFFFFFFFFFFFFWW
WWFFFFFFFTFFFFFFFFFFFFFFFFFFFFFFWW
WWFFFFFFFFFFFFFFFFFFFFFFFAFFFFFFWW
WWFFFFFFFFFFFFFFFFFWFFFFFFFFFFFFWW
WWFFFFFFFFFFFFFFFFFWFFFFFFFFFFFFWW
WWFFFFFFAFFFFFFFFFFWFFFFFFFFFFFFWW
WWFFFFFFFFFFFFFFFFFWFFFFFFFFFFFFWW
WWFFFTFFFFFFFFEFFFFWFFFFFFFFFFFFWW
WWFFFFFFFFFFFFFFFFFWFFFFFFFFFFFFWW
WWWFFFWWWWWWWWWWWWWWWWWWWFFFWWWWWW
WWFFFFFFFFFFFFFFFFFFFFFFFFFFFFFFWW
WWFTFFFFFFFFFFFFFFFFFFFFFRFFFFFFWW
WWFFFFFFFFFFFFFFFFFFFFFFFFFFFFFFWW
WWWWWWWWFFFFFFFWWWWWWWWWWWWFFFWWWW
WWFFFFFFFFFFFFFFFFFFFFFFWFFFFFFFWW
WWFFFFFFFFFFFFFFFFFFFFTFWFFFFFFFWW
WWFFRFFFFFFFFFFFFFFFFFFFWFFFEFFFWW
WWFFFFFFFFFFFFFFFFFFFFFFWFFFFFFFWW
WWWWWWWWWFFFFFFWWWWWWWWWWFFFFFFFWW
WWFFFFFFFFFFFFFFFFFFFFFFFFFFFFFFWW
WWFFFFFFFFFFFFFFFFFFFFEFFFFFFFFFWW
WWFFFFFFFFFFFFFFFFFFFFFFFFFFFTFFWW
WWFFFFFFFFFFFFFFFFFFFFFFFFFFFFFFWW
WWFFFWWWWWFFFFFFFFFFWWWWWWWWWWWWWW
WWFFFFFFFWFFFFFFFFFFWFFFFFFFFFFFWW
WWFFFFFFFFFFFFFFFFFFFFFFFFFFPFFFWW
WWFFFFFFFFFFFFFFFFFFFFFFFFFFFFFFWW
WWWWWWWWWWWWWWWWWWWWWWWWWWWWWWWWWW
WWWWWWWWWWWWWWWWWWWWWWWWWWWWWWWWWW
