WWWWWWWWWWWWWWWWWWWWWWWWWWWWWWWWWW
WWWWWWWWWWWWWWWWWWWWWWWWWWWWWWWWWW
WWFFFFFFFFFFFFFFFFFFFFFFFFFFFFFFWW
WWFFTFFFFFFFFFTFFFFFTFFFFFFFFFFFWW
WWFFFFFAFFFWWFFFFFFFFFWWFFTFFFFFWW
WWFFFFFFFWWWWFFFFFFFFFWWWWFFFFFFWW
WWFFFWWWWWWWWFFFFFFFFFWWWWWWWFFFWW
WWFFFFFFFFWWWFFFFFFFFFWWWFFFFFFFWW
WWFFFFFTFFFFWFFFFFFFFFWFFFFFFFFFWW
WWFFFFFFFFFFFFFFFFFFFFFFFFFFFFFFWW
WWFFFFFFFFFFFFFFFFFFFFFFFFFFFFFFWW
WWFFFFFFFFFFFFFFFFFFFFFFFFFFFFFFWW
WWFFFFFFFFFFFWWWFFFWWWWWWFFFFWWWWW
WWFFFWWWWWWWWWFFFFFFFWFFFFFFFFFFWW
WWFFFFFFFFFFFWFFFFFFFWFEFFFFFFTFWW
WWFFFFTFFFTFFWFFFFFFFWFFFFFFFFFFWW
WWFFFFFFFFFFFWFFFFFFFWFFFFFFFFFFWW
WWFFFFFFFFFFFWFFFPFFFWFTFFFFFFRFWW
WWFFFFFFFFFFFWFFFFFFFWFFFFFFFFFFWW
WWWWWWWFFFWWWWWWWWWWWWWWWFFFWWWWWW
WWFFFFFFFFFFFFFFFFFFFFFFFFFFFFFFWW
WWFFFRFFFFFFFFFFFFFFFFFFFFFFEFFFWW
WWFFFFFFFFFFFFFFFFFFFFFFFFFFFFFFWW
WWFFFFFWWWWFFFAFFAFFAFFWWWWFFFFFWW
WWFFFFWFFFFFFFFFFFFFFFFFFFFWFFFFWW
WWFFFWFFFAFFAFFAFFAFFAFFAFFFWFFFWW
WWFFFFWFFFFFFFFFFFFFFFFFFFFWFFFFWW
WWFFFFFWFFAFFFFFFFFFFFFAFFWFFFFFWW
WWFFFFFFWFFFFWWWWWWWWFFFFWFFFFFFWW
WWFFFFFFFWFFFFFFFFFFFFFFWFFFFFFFWW
WWFFFRFFFFWFFAFFAFFAFFFWFFFFEFFFWW
WWFFFFFFFFFWFFFFFFFFFFWFFFFFFFFFWW
WWWWWWWWWWWWWWWWWWWWWWWWWWWWWWWWWW
WWWWWWWWWWWWWWWWWWWWWWWWWWWWWWWWWW
