WWWWWWWWWWWWWWWWWWWWWWWWWWWWWWWWWW
WWWWWWWWWWWWWWWWWWWWWWWWWWWWWWWWWW
WWFFFFFFFFFFFFFFFFFFFFFFFFFFFFFFWW
WWFFFFFFFFFFFTFFFFFTFFFFFFFFFTFFWW
WWFFFFFTFFWWFFFFFFFFFWWFFFAFFFFFWW
WWFFFFFFWWWWFFFFFFFFFWWWWFFFFFFFWW
WWFFFWWWWWWWFFFFFFFFFWWWWWWWWFFFWW
WWFFFFFFFWWWFFFFFFFFFWWWFFFFFFFFWW
WWFFFFFFFFFWFFFFFFFFFWFFFFTFFFFFWW
WWFFFFFFFFFFFFFFFFFFFFFFFFFFFFFFWW
WWFFFFFFFFFFFFFFFFFFFFFFFFFFFFFFWW
WWFFFFFFFFFFFFFFFFFFFFFFFFFFFFFFWW
WWWWWFFFFWWWWWWFFFWWWFFFFFFFFFFFWW
WWFFFFFFFFFFWFFFFFFFWWWWWWWWWFFFWW
WWFTFFFFFFEFWFFFFFFFWFFFFFFFFFFFWW
WWFFFFFFFFFFWFFFFFFFWFFTFFFTFFFFWW
WWFFFFFFFFFFWFFFFFFFWFFFFFFFFFFFWW
WWFRFFFFFFTFWFFFPFFFWFFFFFFFFFFFWW
WWFFFFFFFFFFWFFFFFFFWFFFFFFFFFFFWW
WWWWWWFFFWWWWWWWWWWWWWWWFFFWWWWWWW
WWFFFFFFFFFFFFFFFFFFFFFFFFFFFFFFWW
WWFFFEFFFFFFFFFFFFFFFFFFFFFFRFFFWW
WWFFFFFFFFFFFFFFFFFFFFFFFFFFFFFFWW
WWFFFFFWWWWFFAFFAFFAFFFWWWWFFFFFWW
WWFFFFWFFFFFFFFFFFFFFFFFFFFWFFFFWW
WWFFFWFFFAFFAFFAFFAFFAFFAFFFWFFFWW
WWFFFFWFFFFFFFFFFFFFFFFFFFFWFFFFWW
WWFFFFFWFFAFFFFFFFFFFFFAFFWFFFFFWW
WWFFFFFFWFFFFWWWWWWWWFFFFWFFFFFFWW
WWFFFFFFFWFFFFFFFFFFFFFFWFFFFFFFWW
WWFFFEFFFFWFFFAFFAFFAFFWFFFFRFFFWW
WWFFFFFFFFFWFFFFFFFFFFWFFFFFFFFFWW
WWWWWWWWWWWWWWWWWWWWWWWWWWWWWWWWWW
WWWWWWWWWWWWWWWWWWWWWWWWWWWWWWWWWW
