WWWWWWWWWWWWWWWWWWWWWWWWWWWWWWWWWW
WWWWWWWWWWWWWWWWWWWWWWWWWWWWWWWWWW
WWFFFFFFFFFWFFFFFFFFFFWFFFFFFFFFWW
WWFFFEFFFFWFFFAFFAFFAFFWFFFFRFFFWW
WWFFFFFFFWFFFFFFFFFFFFFFWFFFFFFFWW
WWFFFFFFWFFFFWWWWWWWWFFFFWFFFFFFWW
WWFFFFFWFFAFFFFFFFFFFFFAFFWFFFFFWW
WWFFFFWFFFFFFFFFFFFFFFFFFFFWFFFFWW
WWFFFWFFFAFFAFFAFFAFFAFFAFFFWFFFWW
WWFFFFWFFFFFFFFFFFFFFFFFFFFWFFFFWW
WWFFFFFWWWWFFAFFAFFAFFFWWWWFFFFFWW
WWFFFFFFFFFFFFFFFFFFFFFFFFFFFFFFWW
WWFFFEFFFFFFFFFFFFFFFFFFFFFFRFFFWW
WWFFFFFFFFFFFFFFFFFFFFFFFFFFFFFFWW
WWWWWWFFFWWWWWWWWWWWWWWWFFFWWWWWWW
WWFFFFFFFFFFWFFFFFFFWFFFFFFFFFFFWW
WWFRFFFFFFTFWFFFPFFFWFFFFFFFFFFFWW
WWFFFFFFFFFFWFFFFFFFWFFFFFFFFFFFWW
WWFFFFFFFFFFWFFFFFFFWFFTFFFTFFFFWW
WWFTFFFFFFEFWFFFFFFFWFFFFFFFFFFFWW
WWFFFFFFFFFFWFFFFFFFWWWWWWWWWFFFWW
WWWWWFFFFWWWWWWFFFWWWFFFFFFFFFFFWW
WWFFFFFFFFFFFFFFFFFFFFFFFFFFFFFFWW
WWFFFFFFFFFFFFFFFFFFFFFFFFFFFFFFWW
WWFFFFFFFFFFFFFFFFFFFFFFFFFFFFFFWW
WWFFFFFFFFFWFFFFFFFFFWFFFFTFFFFFWW
WWFFFFFFFWWWFFFFFFFFFWWWFFFFFFFFWW
WWFFFWWWWWWWFFFFFFFFFWWWWWWWWFFFWW
WWFFFFFFWWWWFFFFFFFFFWWWWFFFFFFFWW
WWFFFFFTFFWWFFFFFFFFFWWFFFAFFFFFWW
WWFFFFFFFFFFFTFFFFFTFFFFFFFFFTFFWW
WWFFFFFFFFFFFFFFFFFFFFFFFFFFFFFFWW
WWWWWWWWWWWWWWWWWWWWWWWWWWWWWWWWWW
WWWWWWWWWWWWWWWWWWWWWWWWWWWWWWWWWW
