WWWWWWWWWWWWWWWWWWWWWWWWWWWWWWWWWW
WWWWWWWWWWWWWWWWWWWWWWWWWWWWWWWWWW
WWFFFFFFFFFWFFFFFFFFFFWFFFFFFFFFWW
WWFFFRFFFFWFFAFFAFFAFFFWFFFFEFFFWW
WWFFFFFFFWFFFFFFFFFFFFFFWFFFFFFFWW
WWFFFFFFWFFFFWWWWWWWWFFFFWFFFFFFWW
WWFFFFFWFFAFFFFFFFFFFFFAFFWFFFFFWW
WWFFFFWFFFFFFFFFFFFFFFFFFFFWFFFFWW
WWFFFWFFFAFFAFFAFFAFFAFFAFFFWFFFWW
WWFFFFWFFFFFFFFFFFFFFFFFFFFWFFFFWW
WWFFFFFWWWWFFFAFFAFFAFFWWWWFFFFFWW
WWFFFFFFFFFFFFFFFFFFFFFFFFFFFFFFWW
WWFFFRFFFFFFFFFFFFFFFFFFFFFFEFFFWW
WWFFFFFFFFFFFFFFFFFFFFFFFFFFFFFFWW
WWWWWWWFFFWWWWWWWWWWWWWWWFFFWWWWWW
WWFFFFFFFFFFFWFFFFFFFWFFFFFFFFFFWW
WWFFFFFFFFFFFWFFFPFFFWFTFFFFFFRFWW
WWFFFFFFFFFFFWFFFFFFFWFFFFFFFFFFWW
WWFFFFTFFFTFFWFFFFFFFWFFFFFFFFFFWW
WWFFFFFFFFFFFWFFFFFFFWFEFFFFFFTFWW
WWFFFWWWWWWWWWFFFFFFFWFFFFFFFFFFWW
WWFFFFFFFFFFFWWWFFFWWWWWWFFFFWWWWW
WWFFFFFFFFFFFFFFFFFFFFFFFFFFFFFFWW
WWFFFFFFFFFFFFFFFFFFFFFFFFFFFFFFWW
WWFFFFFFFFFFFFFFFFFFFFFFFFFFFFFFWW
WWFFFFFTFFFFWFFFFFFFFFWFFFFFFFFFWW
WWFFFFFFFFWWWFFFFFFFFFWWWFFFFFFFWW
WWFFFWWWWWWWWFFFFFFFFFWWWWWWWFFFWW
WWFFFFFFFWWWWFFFFFFFFFWWWWFFFFFFWW
WWFFFFFAFFFWWFFFFFFFFFWWFFTFFFFFWW
WWFFTFFFFFFFFFTFFFFFTFFFFFFFFFFFWW
WWFFFFFFFFFFFFFFFFFFFFFFFFFFFFFFWW
WWWWWWWWWWWWWWWWWWWWWWWWWWWWWWWWWW
WWWWWWWWWWWWWWWWWWWWWWWWWWWWWWWWWW
