WWWWWWWWWWWWWWWWWWWWWWWWWWWWWWWWWW
WWWWWWWWWWWWWWWWWWWWWWWWWWWWWWWWWW
WWFFFFFFFFFFFFFFFFFFFFFFFFFFFFFFWW
WWFFFFFFTFFFFFTFFFFFTFFFFFFTFFFFWW
WWFFFFFFFFFFFFFFFFFFFFFFFFFFFFFFWW
WWWWFAFWWWFAFWWWFAFWWWFFAFWWWFFFWW
WWWWFFFWWWFFFWWWFFFWWWFFFFWWWFFFWW
WWFFFFFFFFFFFCFFFFFFFCFFFFFFFFFFWW
WWFFFTFFFEFFFCTFFFFFFCTFFFEFFFTFWW
WWFFFFFFFFFFFCFFFFFFFCFFFFFFFFFFWW
WWFFWWWWFFFFWWWWFFFFWWWWFFFFWWWWWW
WWFFWWWWFAFFWWWWFFAFWWWWFAFFWWWWWW
WWFFWWWWFFFFWWWWFFFFWWWWFFFFWWWWWW
WWFFWWWWFFFFWWWWFFFFWWWWFFFFWWWWWW
WWFFFCFFFFFFFCFFFFFFFFFCFFFFFFFFWW
WWFTFCFFFFFFFCTFFFFRFFFCTFFFFFFFWW
WWFFFCFFFFFFFCFFFFFFFFFCFFFFFFFFWW
WWWWWWWFFFFFWWWWWFFFFFWWWWWFFFFFWW
WWWWWWWFFFFFWWWWWFFFFFWWWWWFFFFFWW
WWWWWWWFFAFFWWWWWFFAFFWWWWWFFFFFWW
WWWWWWWFFFFFWWWWWFFFFFWWWWWFFFFFWW
WWWWWWWFFFFFWWWWWFFFFFWWWWWFFFFFWW
WWFFCFFFFFFFFFFCFFFFFFFFFFCFFFFFWW
WWFRCFFFFFFFFFFCFFFFFFTFFFCFFFFFWW
WWFFCFFFFFFFFFFCFFFFFFFFFFCFFFFFWW
WWWWWWWWFFFFFFWWWWWWFFFFFFWWWWWWWW
WWWWWWWWFFFFFFWWWWWWFFFFFFWWWWWWWW
WWWWWWWWFFEFFFWWWWWWFFRFFFWWWWWWWW
WWWWWWWWFFFFFFWWWWWWFFFFFFWWWWWWWW
WWFFFFFFFFFFFFFFFFFFFFFFFFFFFFFFWW
WWFFFFFFFFFFFFFFFFFFFFFFFFFFFPFFWW
WWFFFFFFFFFFFFFFFFFFFFFFFFFFFFFFWW
WWWWWWWWWWWWWWWWWWWWWWWWWWWWWWWWWW
WWWWWWWWWWWWWWWWWWWWWWWWWWWWWWWWWW