WWWWWWWWWWWWWWWWWWWWWWWWWWWWWWWWWW
WWWWWWWWWWWWWWWWWWWWWWWWWWWWWWWWWW
WWFFFFFFFFFFFFFFFFFFFFFFFFFFFFFFWW
WWFFPFFFFFFFFFFFFFFFFFFFFFFFFFFFWW
WWFFFFFFFFFFFFFFFFFFFFFFFFFFFFFFWW
WWWWWWWWFFFFFFWWWWWWFFFFFFWWWWWWWW
WWWWWWWWFFFRFFWWWWWWFFFEFFWWWWWWWW
WWWWWWWWFFFFFFWWWWWWFFFFFFWWWWWWWW
WWWWWWWWFFFFFFWWWWWWFFFFFFWWWWWWWW
WWFFFFFCFFFFFFFFFFCFFFFFFFFFFCFFWW
WWFFFFFCFFFTFFFFFFCFFFFFFFFFFCRFWW
WWFFFFFCFFFFFFFFFFCFFFFFFFFFFCFFWW
WWFFFFFWWWWWFFFFFWWWWWFFFFFWWWWWWW
WWFFFFFWWWWWFFFFFWWWWWFFFFFWWWWWWW
WWFFFFFWWWWWFFAFFWWWWWFFAFFWWWWWWW
WWFFFFFWWWWWFFFFFWWWWWFFFFFWWWWWWW
WWFFFFFWWWWWFFFFFWWWWWFFFFFWWWWWWW
WWFFFFFFFFCFFFFFFFFFCFFFFFFFCFFFWW
WWFFFFFFFTCFFFRFFFFTCFFFFFFFCFTFWW
WWFFFFFFFFCFFFFFFFFFCFFFFFFFCFFFWW
WWWWWWFFFFWWWWFFFFWWWWFFFFWWWWFFWW
WWWWWWFFFFWWWWFFFFWWWWFFFFWWWWFFWW
WWWWWWFFAFWWWWFAFFWWWWFFAFWWWWFFWW
WWWWWWFFFFWWWWFFFFWWWWFFFFWWWWFFWW
WWFFFFFFFFFFCFFFFFFFCFFFFFFFFFFFWW
WWFTFFFEFFFTCFFFFFFTCFFFEFFFTFFFWW
WWFFFFFFFFFFCFFFFFFFCFFFFFFFFFFFWW
WWFFFWWWFFFFWWWFFFWWWFFFWWWFFFWWWW
WWFFFWWWFAFFWWWFAFWWWFAFWWWFAFWWWW
WWFFFFFFFFFFFFFFFFFFFFFFFFFFFFFFWW
WWFFFFTFFFFFFTFFFFFTFFFFFTFFFFFFWW
WWFFFFFFFFFFFFFFFFFFFFFFFFFFFFFFWW
WWWWWWWWWWWWWWWWWWWWWWWWWWWWWWWWWW
WWWWWWWWWWWWWWWWWWWWWWWWWWWWWWWWWW