WWWWWWWWWWWWWWWWWWWWWWWWWWWWWWWWWW
WWWWWWWWWWWWWWWWWWWWWWWWWWWWWWWWWW
WWFFFFFFFFFFFFFFFFFFFFFFFFFFFFFFWW
WWFFFFTFFFFFFTFFFFFTFFFFFTFFFFFFWW
WWFFFFFFFFFFFFFFFFFFFFFFFFFFFFFFWW
WWFFFWWWFAFFWWWFAFWWWFAFWWWFAFWWWW
WWFFFWWWFFFFWWWFFFWWWFFFWWWFFFWWWW
WWFFFFFFFFFFCFFFFFFFCFFFFFFFFFFFWW
WWFTFFFEFFFTCFFFFFFTCFFFEFFFTFFFWW
WWFFFFFFFFFFCFFFFFFFCFFFFFFFFFFFWW
WWWWWWFFFFWWWWFFFFWWWWFFFFWWWWFFWW
WWWWWWFFAFWWWWFAFFWWWWFFAFWWWWFFWW
WWWWWWFFFFWWWWFFFFWWWWFFFFWWWWFFWW
WWWWWWFFFFWWWWFFFFWWWWFFFFWWWWFFWW
WWFFFFFFFFCFFFFFFFFFCFFFFFFFCFFFWW
WWFFFFFFFTCFFFRFFFFTCFFFFFFFCFTFWW
WWFFFFFFFFCFFFFFFFFFCFFFFFFFCFFFWW
WWFFFFFWWWWWFFFFFWWWWWFFFFFWWWWWWW
WWFFFFFWWWWWFFFFFWWWWWFFFFFWWWWWWW
WWFFFFFWWWWWFFAFFWWWWWFFAFFWWWWWWW
WWFFFFFWWWWWFFFFFWWWWWFFFFFWWWWWWW
WWFFFFFWWWWWFFFFFWWWWWFFFFFWWWWWWW
WWFFFFFCFFFFFFFFFFCFFFFFFFFFFCFFWW
WWFFFFFCFFFTFFFFFFCFFFFFFFFFFCRFWW
WWFFFFFCFFFFFFFFFFCFFFFFFFFFFCFFWW
WWWWWWWWFFFFFFWWWWWWFFFFFFWWWWWWWW
WWWWWWWWFFFFFFWWWWWWFFFFFFWWWWWWWW
WWWWWWWWFFFRFFWWWWWWFFFEFFWWWWWWWW
WWWWWWWWFFFFFFWWWWWWFFFFFFWWWWWWWW
WWFFFFFFFFFFFFFFFFFFFFFFFFFFFFFFWW
WWFFPFFFFFFFFFFFFFFFFFFFFFFFFFFFWW
WWFFFFFFFFFFFFFFFFFFFFFFFFFFFFFFWW
WWWWWWWWWWWWWWWWWWWWWWWWWWWWWWWWWW
WWWWWWWWWWWWWWWWWWWWWWWWWWWWWWWWWW
