WWWWWWWWWWWWWWWWWWWWWWWWWWWWWWWWWW
WWWWWWWWWWWWWWWWWWWWWWWWWWWWWWWWWW
WWFFFFFFFFFFFFFFWFFFFFFFFFFFFFFFWW
WWFPFFFFFFFFFFFFWFFFAFFFFFFFEFFFWW
WWFFFWWWWFFFFWWWWFFFFFFFFFFFFFFFWW
WWWWWFFFFFFFFFFFWFFFFFFFWWWWWWWWWW
WWFFFFFFFFFFFFFFWFFFEFFFFFFFFFFFWW
WWFFTFFFFFFFFFFFWFFFFFFFFFFFFTFFWW
WWFFFFFFFFFFFFFFFWFFFFFFFFFFFFFFWW
WWWWWWWWFFFWWFFFFFWWWFFFFWWWWWWWWW
WWFFFFFFFFFFFWFFFFFFFFFFFFFFFFFFWW
WWFFTFFFFFFTFFWFFFFAFFFFFFFFTFFFWW
WWFFFFFFFFFFFFFWFFFFFFFFFFFFFFFFWW
WWFFFFWWWWWWWWWWWWWWFFFWWWWFFFWWWW
WWFFFFFFFFFFFFFFFFFFFFFFFFWFFFAFWW
WWFFFFFFEFFFFFFFFFFFFFFFFFWWWFFFWW
WWFFFFFFFFFFFFFFFFFFFFFFFFWFFFFFWW
WWWWWWFFFFFFWFFWFFFFFFWWWWWFFEFFWW
WWFFFFFFFFWWFFFFWWFFFFFFFFWFFFFFWW
WWFFFFFFWWFFFFFFFFWWFFFAFFWFAFWWWW
WWFFFFFWFFFFFFFFFFFFWFFFFFWFFFFFWW
WWFFAFFFFFFFFFMFFFFFFFFFFFWFFFTFWW
WWFFFFFWFFFFFFFFFFFFWFFFFFWWFFFFWW
WWFFFFFFWWFFFFFFFFWWFFFAFFWFFFRFWW
WWFFFFFFFFWWFFFFWWFFFFFFFFWFFFFFWW
WWWWWFFFFFFFWFFWFFFFFFFWWWWFAFFWWW
WWFFFFFFFFFFFFFFFFFFFFFFFFWFFFFFWW
WWFFFFFFTFFFFFFFFFFFFTFFFFWFFFAFWW
WWFFFFFFFFFFFFFFFFFFFFFFFFWFFFFFWW
WWWWFFFWWWFFFWWWFFFFWWWFFFWWWFFFWW
WWFFFEFFFFFRFFFFFFFFFFFFRFFFFFMFWW
WWFFFFFFFFFFFFFFFFFFFFFFFFFFFFFFWW
WWWWWWWWWWWWWWWWWWWWWWWWWWWWWWWWWW
WWWWWWWWWWWWWWWWWWWWWWWWWWWWWWWWWW
