WWWWWWWWWWWWWWWWWWWWWWWWWWWWWWWWWW
WWWWWWWWWWWWWWWWWWWWWWWWWWWWWWWWWW
WWFFFFFFFFFFFFFFFFFFFFFFFFFFFFFFWW
WWFMFFFFFRFFFFFFFFFFFFRFFFFFEFFFWW
WWFFFWWWFFFWWWFFFFWWWFFFWWWFFFWWWW
WWFFFFFWFFFFFFFFFFFFFFFFFFFFFFFFWW
WWFAFFFWFFFFTFFFFFFFFFFFFTFFFFFFWW
WWFFFFFWFFFFFFFFFFFFFFFFFFFFFFFFWW
WWWFFAFWWWWFFFFFFFWFFWFFFFFFFWWWWW
WWFFFFFWFFFFFFFFWWFFFFWWFFFFFFFFWW
WWFRFFFWFFAFFFWWFFFFFFFFWWFFFFFFWW
WWFFFFWWFFFFFWFFFFFFFFFFFFWFFFFFWW
WWFTFFFWFFFFFFFFFFFMFFFFFFFFFAFFWW
WWFFFFFWFFFFFWFFFFFFFFFFFFWFFFFFWW
WWWWFAFWFFAFFFWWFFFFFFFFWWFFFFFFWW
WWFFFFFWFFFFFFFFWWFFFFWWFFFFFFFFWW
WWFFEFFWWWWWFFFFFFWFFWFFFFFFWWWWWW
WWFFFFFWFFFFFFFFFFFFFFFFFFFFFFFFWW
WWFFFWWWFFFFFFFFFFFFFFFFFEFFFFFFWW
WWFAFFFWFFFFFFFFFFFFFFFFFFFFFFFFWW
WWWWFFFWWWWFFFWWWWWWWWWWWWWWFFFFWW
WWFFFFFFFFFFFFFFFFWFFFFFFFFFFFFFWW
WWFFFTFFFFFFFFAFFFFWFFTFFFFFFTFFWW
WWFFFFFFFFFFFFFFFFFFWFFFFFFFFFFFWW
WWWWWWWWWFFFFWWWFFFFFWWFFFWWWWWWWW
WWFFFFFFFFFFFFFFWFFFFFFFFFFFFFFFWW
WWFFTFFFFFFFFFFFFWFFFFFFFFFFFTFFWW
WWFFFFFFFFFFFEFFFWFFFFFFFFFFFFFFWW
WWWWWWWWWWFFFFFFFWFFFFFFFFFFFWWWWW
WWFFFFFFFFFFFFFFFWWWWFFFFWWWWFFFWW
WWFFFEFFFFFFFAFFFWFFFFFFFFFFFFPFWW
WWFFFFFFFFFFFFFFFWFFFFFFFFFFFFFFWW
WWWWWWWWWWWWWWWWWWWWWWWWWWWWWWWWWW
WWWWWWWWWWWWWWWWWWWWWWWWWWWWWWWWWW
