WWWWWWWWWWWWWWWWWWWWWWWWWWWWWWWWWW
WWWWWWWWWWWWWWWWWWWWWWWWWWWWWWWWWW
WWFFFFFFFFFFFFFFFWFFFFFFFFFFFFFFWW
WWFFFEFFFFFFFAFFFWFFFFFFFFFFFFPFWW
WWFFFFFFFFFFFFFFFWWWWFFFFWWWWFFFWW
WWWWWWWWWWFFFFFFFWFFFFFFFFFFFWWWWW
WWFFFFFFFFFFFEFFFWFFFFFFFFFFFFFFWW
WWFFTFFFFFFFFFFFFWFFFFFFFFFFFTFFWW
WWFFFFFFFFFFFFFFWFFFFFFFFFFFFFFFWW
WWWWWWWWWFFFFWWWFFFFFWWFFFWWWWWWWW
WWFFFFFFFFFFFFFFFFFFWFFFFFFFFFFFWW
WWFFFTFFFFFFFFAFFFFWFFTFFFFFFTFFWW
WWFFFFFFFFFFFFFFFFWFFFFFFFFFFFFFWW
WWWWFFFWWWWFFFWWWWWWWWWWWWWWFFFFWW
WWFAFFFWFFFFFFFFFFFFFFFFFFFFFFFFWW
WWFFFWWWFFFFFFFFFFFFFFFFFEFFFFFFWW
WWFFFFFWFFFFFFFFFFFFFFFFFFFFFFFFWW
WWFFEFFWWWWWFFFFFFWFFWFFFFFFWWWWWW
WWFFFFFWFFFFFFFFWWFFFFWWFFFFFFFFWW
WWWWFAFWFFAFFFWWFFFFFFFFWWFFFFFFWW
WWFFFFFWFFFFFWFFFFFFFFFFFFWFFFFFWW
WWFTFFFWFFFFFFFFFFFMFFFFFFFFFAFFWW
WWFFFFWWFFFFFWFFFFFFFFFFFFWFFFFFWW
WWFRFFFWFFAFFFWWFFFFFFFFWWFFFFFFWW
WWFFFFFWFFFFFFFFWWFFFFWWFFFFFFFFWW
WWWFFAFWWWWFFFFFFFWFFWFFFFFFFWWWWW
WWFFFFFWFFFFFFFFFFFFFFFFFFFFFFFFWW
WWFAFFFWFFFFTFFFFFFFFFFFFTFFFFFFWW
WWFFFFFWFFFFFFFFFFFFFFFFFFFFFFFFWW
WWFFFWWWFFFWWWFFFFWWWFFFWWWFFFWWWW
WWFMFFFFFRFFFFFFFFFFFFRFFFFFEFFFWW
WWFFFFFFFFFFFFFFFFFFFFFFFFFFFFFFWW
WWWWWWWWWWWWWWWWWWWWWWWWWWWWWWWWWW
WWWWWWWWWWWWWWWWWWWWWWWWWWWWWWWWWW
