WWWWWWWWWWWWWWWWWWWWWWWWWWWWWWWWWW
WWWWWWWWWWWWWWWWWWWWWWWWWWWWWWWWWW
WWFFFFFFFFFFFFFFFFFFFFFFFFFFFFFFWW
WWFFFFMFFFFFFFFFFFMFFFFFFFMFFFFFWW
WWFFWFFFWFFFWFFFWFFFWFFFWFFFWFFFWW
WWFFFFFFCCFFFFFFFFFFFFFCCFFFFFFFWW
WWFFFFFFCCFFFFFFFFFAFFFCCFFFFFFFWW
WWFFFFFFCCFFAFFFFFFFFFFCCFFFFFFFWW
WWFFFFFFCCFFFFFFAFFFFFFCCFFFFFFFWW
WWFFFFFFCCFFFFFFFFFFFFFCCFEFFFFFWW
WWFFFFFFCCFFFFFAFFFFFFFCCFFFFFFFWW
WWFFFFFFWWFFFFFFFFFFFWWWWFFFFFFFWW
WWWWWWFFFFFFFFFFWFFFFFFFFFTFFFFFWW
WWWWWWWWWFFFFFFFFFFFFFFFFFFFFFFFWW
WWFFFWWWWFFWWFFFFFFFFFFFFFFFFFFFWW
WWFFFFFFFFFWWFFFFFFWWFFFFWWFFFFFWW
WWFPFFFFFFFWWFFEFFFFFFFFFFFFFFFFWW
WWFFFFFFFFFWWFFFFFFFFFFFFFFFFFFFWW
WWFFFWWWWFFWWFFFFFFFWFFFFFFFFFFFWW
WWWWWWWWWFFWWFFTFFFFWFFFFFFMFFFFWW
WWWWWFFFFFFWWFFFFFFFFFFFFFFFFFFFWW
WWFFFFFFFFFWWFFFFFFFFFFFFFFFFFFFWW
WWFFFFFWWWWWWFFWWFFFWWFFFFFWWFFFWW
WWFFWWWWWFFFFFFFFFFFFFFFFFFFFFFFWW
WWFFFFFFAFFFFFFFFFFFFFFFFFFFFFFFWW
WWFFFFFFFFFFFFFFWFFFFFFFWFFFFFFFWW
WWFFWWFFRFFFFFFFFFFFFFFFFFFTFFFFWW
WWFFWWFFFFFFFFFFFFFFFFFFFFFFFFFFWW
WWFFWWWWWFFWWFFWWFFWWFFWWFFWWFFFWW
WWFFWWWWWFFWWFFWWFFWWFFWWFFWWFFFWW
WWFFFFFFFFFFFFEFFFFFFFFFFFRFFFFFWW
WWFFFFFFFFFFFFFFFFFFFFFFFFFFFFFFWW
WWWWWWWWWWWWWWWWWWWWWWWWWWWWWWWWWW
WWWWWWWWWWWWWWWWWWWWWWWWWWWWWWWWWW
