WWWWWWWWWWWWWWWWWWWWWWWWWWWWWWWWWW
WWWWWWWWWWWWWWWWWWWWWWWWWWWWWWWWWW
WWFFFFFFFFFFFFFFFFFFFFFFFFFFFFFFWW
WWFFFFFMFFFFFFFMFFFFFFFFFFFMFFFFWW
WWFFFWFFFWFFFWFFFWFFFWFFFWFFFWFFWW
WWFFFFFFFCCFFFFFFFFFFFFFCCFFFFFFWW
WWFFFFFFFCCFFFAFFFFFFFFFCCFFFFFFWW
WWFFFFFFFCCFFFFFFFFFFAFFCCFFFFFFWW
WWFFFFFFFCCFFFFFFAFFFFFFCCFFFFFFWW
WWFFFFFEFCCFFFFFFFFFFFFFCCFFFFFFWW
WWFFFFFFFCCFFFFFFFAFFFFFCCFFFFFFWW
WWFFFFFFFWWWWFFFFFFFFFFFWWFFFFFFWW
WWFFFFFTFFFFFFFFFWFFFFFFFFFFWWWWWW
WWFFFFFFFFFFFFFFFFFFFFFFFWWWWWWWWW
WWFFFFFFFFFFFFFFFFFFFWWFFWWWWFFFWW
WWFFFFFWWFFFFWWFFFFFFWWFFFFFFFFFWW
WWFFFFFFFFFFFFFFFFEFFWWFFFFFFFPFWW
WWFFFFFFFFFFFFFFFFFFFWWFFFFFFFFFWW
WWFFFFFFFFFFFWFFFFFFFWWFFWWWWFFFWW
WWFFFFMFFFFFFWFFFFTFFWWFFWWWWWWWWW
WWFFFFFFFFFFFFFFFFFFFWWFFFFFFWWWWW
WWFFFFFFFFFFFFFFFFFFFWWFFFFFFFFFWW
WWFFFWWFFFFFWWFFFWWFFWWWWWWFFFFFWW
WWFFFFFFFFFFFFFFFFFFFFFFFWWWWWFFWW
WWFFFFFFFFFFFFFFFFFFFFFFFAFFFFFFWW
WWFFFFFFFWFFFFFFFWFFFFFFFFFFFFFFWW
WWFFFFTFFFFFFFFFFFFFFFFFFRFFWWFFWW
WWFFFFFFFFFFFFFFFFFFFFFFFFFFWWFFWW
WWFFFWWFFWWFFWWFFWWFFWWFFWWWWWFFWW
WWFFFWWFFWWFFWWFFWWFFWWFFWWWWWFFWW
WWFFFFFRFFFFFFFFFFFEFFFFFFFFFFFFWW
WWFFFFFFFFFFFFFFFFFFFFFFFFFFFFFFWW
WWWWWWWWWWWWWWWWWWWWWWWWWWWWWWWWWW
WWWWWWWWWWWWWWWWWWWWWWWWWWWWWWWWWW

