WWWWWWWWWWWWWWWWWWWWWWWWWWWWWWWWWW
WWWWWWWWWWWWWWWWWWWWWWWWWWWWWWWWWW
WWFFFFFFFFFFFFFFFFFFFFFFFFFFFFFFWW
WWFFFFFRFFFFFFFFFFFEFFFFFFFFFFFFWW
WWFFFWWFFWWFFWWFFWWFFWWFFWWWWWFFWW
WWFFFWWFFWWFFWWFFWWFFWWFFWWWWWFFWW
WWFFFFFFFFFFFFFFFFFFFFFFFFFFWWFFWW
WWFFFFTFFFFFFFFFFFFFFFFFFRFFWWFFWW
WWFFFFFFFWFFFFFFFWFFFFFFFFFFFFFFWW
WWFFFFFFFFFFFFFFFFFFFFFFFAFFFFFFWW
WWFFFFFFFFFFFFFFFFFFFFFFFWWWWWFFWW
WWFFFWWFFFFFWWFFFWWFFWWWWWWFFFFFWW
WWFFFFFFFFFFFFFFFFFFFWWFFFFFFFFFWW
WWFFFFFFFFFFFFFFFFFFFWWFFFFFFWWWWW
WWFFFFMFFFFFFWFFFFTFFWWFFWWWWWWWWW
WWFFFFFFFFFFFWFFFFFFFWWFFWWWWFFFWW
WWFFFFFFFFFFFFFFFFFFFWWFFFFFFFFFWW
WWFFFFFFFFFFFFFFFFEFFWWFFFFFFFPFWW
WWFFFFFWWFFFFWWFFFFFFWWFFFFFFFFFWW
WWFFFFFFFFFFFFFFFFFFFWWFFWWWWFFFWW
WWFFFFFFFFFFFFFFFFFFFFFFFWWWWWWWWW
WWFFFFFTFFFFFFFFFWFFFFFFFFFFWWWWWW
WWFFFFFFFWWWWFFFFFFFFFFFWWFFFFFFWW
WWFFFFFFFCCFFFFFFFAFFFFFCCFFFFFFWW
WWFFFFFEFCCFFFFFFFFFFFFFCCFFFFFFWW
WWFFFFFFFCCFFFFFFAFFFFFFCCFFFFFFWW
WWFFFFFFFCCFFFFFFFFFFAFFCCFFFFFFWW
WWFFFFFFFCCFFFAFFFFFFFFFCCFFFFFFWW
WWFFFFFFFCCFFFFFFFFFFFFFCCFFFFFFWW
WWFFFWFFFWFFFWFFFWFFFWFFFWFFFWFFWW
WWFFFFFMFFFFFFFMFFFFFFFFFFFMFFFFWW
WWFFFFFFFFFFFFFFFFFFFFFFFFFFFFFFWW
WWWWWWWWWWWWWWWWWWWWWWWWWWWWWWWWWW
WWWWWWWWWWWWWWWWWWWWWWWWWWWWWWWWWW