WWWWWWWWWWWWWWWWWWWWWWWWWWWWWWWWWW
WWWWWWWWWWWWWWWWWWWWWWWWWWWWWWWWWW
WWFFFFFFFFFFFFFFFFFFFFFFFFFFFFFFWW
WWFFFFFFFFFFFFEFFFFFFFFFFFRFFFFFWW
WWFFWWWWWFFWWFFWWFFWWFFWWFFWWFFFWW
WWFFWWWWWFFWWFFWWFFWWFFWWFFWWFFFWW
WWFFWWFFFFFFFFFFFFFFFFFFFFFFFFFFWW
WWFFWWFFRFFFFFFFFFFFFFFFFFFTFFFFWW
WWFFFFFFFFFFFFFFWFFFFFFFWFFFFFFFWW
WWFFFFFFAFFFFFFFFFFFFFFFFFFFFFFFWW
WWFFWWWWWFFFFFFFFFFFFFFFFFFFFFFFWW
WWFFFFFWWWWWWFFWWFFFWWFFFFFWWFFFWW
WWFFFFFFFFFWWFFFFFFFFFFFFFFFFFFFWW
WWWWWFFFFFFWWFFFFFFFFFFFFFFFFFFFWW
WWWWWWWWWFFWWFFTFFFFWFFFFFFMFFFFWW
WWFFFWWWWFFWWFFFFFFFWFFFFFFFFFFFWW
WWFFFFFFFFFWWFFFFFFFFFFFFFFFFFFFWW
WWFPFFFFFFFWWFFEFFFFFFFFFFFFFFFFWW
WWFFFFFFFFFWWFFFFFFWWFFFFWWFFFFFWW
WWFFFWWWWFFWWFFFFFFFFFFFFFFFFFFFWW
WWWWWWWWWFFFFFFFFFFFFFFFFFFFFFFFWW
WWWWWWFFFFFFFFFFWFFFFFFFFFTFFFFFWW
WWFFFFFFWWFFFFFFFFFFFWWWWFFFFFFFWW
WWFFFFFFCCFFFFFAFFFFFFFCCFFFFFFFWW
WWFFFFFFCCFFFFFFFFFFFFFCCFEFFFFFWW
WWFFFFFFCCFFFFFFAFFFFFFCCFFFFFFFWW
WWFFFFFFCCFFAFFFFFFFFFFCCFFFFFFFWW
WWFFFFFFCCFFFFFFFFFAFFFCCFFFFFFFWW
WWFFFFFFCCFFFFFFFFFFFFFCCFFFFFFFWW
WWFFWFFFWFFFWFFFWFFFWFFFWFFFWFFFWW
WWFFFFMFFFFFFFFFFFMFFFFFFFMFFFFFWW
WWFFFFFFFFFFFFFFFFFFFFFFFFFFFFFFWW
WWWWWWWWWWWWWWWWWWWWWWWWWWWWWWWWWW
WWWWWWWWWWWWWWWWWWWWWWWWWWWWWWWWWW
