WWWWWWWWWWWWWWWWWWWWWWWWWWWWWWWWWW
WWWWWWWWWWWWWWWWWWWWWWWWWWWWWWWWWW
WWFFCFFFFFFFFFFFFFFFFFCFFFFFFFFFWW
WWFFCFFFAFFFAFFFFFFFFFCFFFFFFFMFWW
WWFFCFFFFFFFFFFFFFFAFFCFFFFFFFFFWW
WWFFFWWWWWFWWWWWFFFFFFFWWWWWWWWWWW
WWFFFWWWFFFFFWWWFFFFFFFFFFFFWWWWWW
WWFFFWWWFFRFFFFFFFFFFFFFFFFFWWWWWW
WWFFFFFFFFFFFWWWFFFFFFFWWWFFWWWWWW
WWFFFFFFFFFFWWWWFFFFFFFWWWFFWWWWWW
WWFFFWWWFFFWWWWWFFFFFFFFFFFFFFFFWW
WWFFFWWWFFFWWWWWFFFMFFFFFFTFFFFFWW
WWFFCFFFFFFFFFFFFFFFFFCFFFFFFFFFWW
WWFFCFFFFFFFFFFFFFFFFFCFFFFFFFFFWW
WWFFCFFFFFFFFFFFFFFFFFCFFFFFFFFFWW
WWFFCFFFFFFFFFFFFFFFFFCFFFFFFFFFWW
WWFFFWWWWFFFFWWWWWWWWWFFFFWWWWFFWW
WWFFFFFFFFFFWWWWWWWWWWWFFFFFFFFFWW
WWFFFFEFFFFFWWFFFFFFFWWFFFFRFFFFWW
WWFFFFFFFFFFWWFFFPFFFWWFFFFFFFFFWW
WWFFFFFFFFFFFWWFFFFFWWFFFFFFFFFFWW
WWWWWFFWWWWFFFFFFFFFFFFFFFFFFFFFWW
WWWWWFFWWWWWFFFFFFFFFFFFFFFTFFFFWW
WWWWWFFWWWWWWFFFFFFFFFFFFFFFFFFFWW
WWWWWFFWWWWWWFFFFFFFFFFFFFFFFFFFWW
WWFFFFFFFFFFFFFFFFWWWWWFWWWWWFFFWW
WWFFFFFFTFFFFFFFFFWWWWFFFWWWWFFFWW
WWFFWFFFFFFFFFFFFFFFFFFEFWWWWFFWWW
WWFFWFFFFFFFFFFFFFWWWWFFFWWWWFFWWW
WWFFFFFFFFFFFFFFFFWWFFFFFFFFFFFWWW
WWFFRFWWWWFFFFFFFFFFFFFFFFTFFFFWWW
WWFFFFFFFFFFFFFFFFFFFFFFFFFFFFFWWW
WWWWWWWWWWWWWWWWWWWWWWWWWWWWWWWWWW
WWWWWWWWWWWWWWWWWWWWWWWWWWWWWWWWWW
