WWWWWWWWWWWWWWWWWWWWWWWWWWWWWWWWWW
WWWWWWWWWWWWWWWWWWWWWWWWWWWWWWWWWW
WWWFFFFFFFFFFFFFFFFFFFFFFFFFFFFFWW
WWWFFFFTFFFFFFFFFFFFFFFFWWWWFRFFWW
WWWFFFFFFFFFFFWWFFFFFFFFFFFFFFFFWW
WWWFFWWWWFFFWWWWFFFFFFFFFFFFFWFFWW
WWWFFWWWWFEFFFFFFFFFFFFFFFFFFWFFWW
WWFFFWWWWFFFWWWWFFFFFFFFFTFFFFFFWW
WWFFFWWWWWFWWWWWFFFFFFFFFFFFFFFFWW
WWFFFFFFFFFFFFFFFFFFFWWWWWWFFWWWWW
WWFFFFFFFFFFFFFFFFFFFWWWWWWFFWWWWW
WWFFFFTFFFFFFFFFFFFFFFWWWWWFFWWWWW
WWFFFFFFFFFFFFFFFFFFFFFWWWWFFWWWWW
WWFFFFFFFFFFWWFFFFFWWFFFFFFFFFFFWW
WWFFFFFFFFFWWFFFPFFFWWFFFFFFFFFFWW
WWFFFFRFFFFWWFFFFFFFWWFFFFFEFFFFWW
WWFFFFFFFFFWWWWWWWWWWWFFFFFFFFFFWW
WWFFWWWWFFFFWWWWWWWWWFFFFWWWWFFFWW
WWFFFFFFFFFCFFFFFFFFFFFFFFFFFCFFWW
WWFFFFFFFFFCFFFFFFFFFFFFFFFFFCFFWW
WWFFFFFFFFFCFFFFFFFFFFFFFFFFFCFFWW
WWFFFFFFFFFCFFFFFFFFFFFFFFFFFCFFWW
WWFFFFFTFFFFFFMFFFWWWWWFFFWWWFFFWW
WWFFFFFFFFFFFFFFFFWWWWWFFFWWWFFFWW
WWWWWWFFWWWFFFFFFFWWWWFFFFFFFFFFWW
WWWWWWFFWWWFFFFFFFWWWFFFFFFFFFFFWW
WWWWWWFFFFFFFFFFFFFFFFFRFFWWWFFFWW
WWWWWWFFFFFFFFFFFFWWWFFFFFWWWFFFWW
WWWWWWWWWWWFFFFFFFWWWWWFWWWWWFFFWW
WWFFFFFFFFFCFFAFFFFFFFFFFFFFFCFFWW
WWFMFFFFFFFCFFFFFFFFFAFFFAFFFCFFWW
WWFFFFFFFFFCFFFFFFFFFFFFFFFFFCFFWW
WWWWWWWWWWWWWWWWWWWWWWWWWWWWWWWWWW
WWWWWWWWWWWWWWWWWWWWWWWWWWWWWWWWWW
