WWWWWWWWWWWWWWWWWWWWWWWWWWWWWWWWWW
WWWWWWWWWWWWWWWWWWWWWWWWWWWWWWWWWW
WWFFFFFFFFFFFFFFFFFFFFFFFFFFFFFWWW
WWFFRFWWWWFFFFFFFFFFFFFFFFTFFFFWWW
WWFFFFFFFFFFFFFFFFWWFFFFFFFFFFFWWW
WWFFWFFFFFFFFFFFFFWWWWFFFWWWWFFWWW
WWFFWFFFFFFFFFFFFFFFFFFEFWWWWFFWWW
WWFFFFFFTFFFFFFFFFWWWWFFFWWWWFFFWW
WWFFFFFFFFFFFFFFFFWWWWWFWWWWWFFFWW
WWWWWFFWWWWWWFFFFFFFFFFFFFFFFFFFWW
WWWWWFFWWWWWWFFFFFFFFFFFFFFFFFFFWW
WWWWWFFWWWWWFFFFFFFFFFFFFFFTFFFFWW
WWWWWFFWWWWFFFFFFFFFFFFFFFFFFFFFWW
WWFFFFFFFFFFFWWFFFFFWWFFFFFFFFFFWW
WWFFFFFFFFFFWWFFFPFFFWWFFFFFFFFFWW
WWFFFFEFFFFFWWFFFFFFFWWFFFFRFFFFWW
WWFFFFFFFFFFWWWWWWWWWWWFFFFFFFFFWW
WWFFFWWWWFFFFWWWWWWWWWFFFFWWWWFFWW
WWFFCFFFFFFFFFFFFFFFFFCFFFFFFFFFWW
WWFFCFFFFFFFFFFFFFFFFFCFFFFFFFFFWW
WWFFCFFFFFFFFFFFFFFFFFCFFFFFFFFFWW
WWFFCFFFFFFFFFFFFFFFFFCFFFFFFFFFWW
WWFFFWWWFFFWWWWWFFFMFFFFFFTFFFFFWW
WWFFFWWWFFFWWWWWFFFFFFFFFFFFFFFFWW
WWFFFFFFFFFFWWWWFFFFFFFWWWFFWWWWWW
WWFFFFFFFFFFFWWWFFFFFFFWWWFFWWWWWW
WWFFFWWWFFRFFFFFFFFFFFFFFFFFWWWWWW
WWFFFWWWFFFFFWWWFFFFFFFFFFFFWWWWWW
WWFFFWWWWWFWWWWWFFFFFFFWWWWWWWWWWW
WWFFCFFFFFFFFFFFFFFAFFCFFFFFFFFFWW
WWFFCFFFAFFFAFFFFFFFFFCFFFFFFFMFWW
WWFFCFFFFFFFFFFFFFFFFFCFFFFFFFFFWW
WWWWWWWWWWWWWWWWWWWWWWWWWWWWWWWWWW
WWWWWWWWWWWWWWWWWWWWWWWWWWWWWWWWWW
