WWWWWWWWWWWWWWWWWWWWWWWWWWWWWWWWWW
WWWWWWWWWWWWWWWWWWWWWWWWWWWWWWWWWW
WWFFFFFFFFFCFFFFFFFFFFFFFFFFFCFFWW
WWFMFFFFFFFCFFFFFFFFFAFFFAFFFCFFWW
WWFFFFFFFFFCFFAFFFFFFFFFFFFFFCFFWW
WWWWWWWWWWWFFFFFFFWWWWWFWWWWWFFFWW
WWWWWWFFFFFFFFFFFFWWWFFFFFWWWFFFWW
WWWWWWFFFFFFFFFFFFFFFFFRFFWWWFFFWW
WWWWWWFFWWWFFFFFFFWWWFFFFFFFFFFFWW
WWWWWWFFWWWFFFFFFFWWWWFFFFFFFFFFWW
WWFFFFFFFFFFFFFFFFWWWWWFFFWWWFFFWW
WWFFFFFTFFFFFFMFFFWWWWWFFFWWWFFFWW
WWFFFFFFFFFCFFFFFFFFFFFFFFFFFCFFWW
WWFFFFFFFFFCFFFFFFFFFFFFFFFFFCFFWW
WWFFFFFFFFFCFFFFFFFFFFFFFFFFFCFFWW
WWFFFFFFFFFCFFFFFFFFFFFFFFFFFCFFWW
WWFFWWWWFFFFWWWWWWWWWFFFFWWWWFFFWW
WWFFFFFFFFFWWWWWWWWWWWFFFFFFFFFFWW
WWFFFFRFFFFWWFFFFFFFWWFFFFFEFFFFWW
WWFFFFFFFFFWWFFFPFFFWWFFFFFFFFFFWW
WWFFFFFFFFFFWWFFFFFWWFFFFFFFFFFFWW
WWFFFFFFFFFFFFFFFFFFFFFWWWWFFWWWWW
WWFFFFTFFFFFFFFFFFFFFFWWWWWFFWWWWW
WWFFFFFFFFFFFFFFFFFFFWWWWWWFFWWWWW
WWFFFFFFFFFFFFFFFFFFFWWWWWWFFWWWWW
WWFFFWWWWWFWWWWWFFFFFFFFFFFFFFFFWW
WWFFFWWWWFFFWWWWFFFFFFFFFTFFFFFFWW
WWWFFWWWWFEFFFFFFFFFFFFFFFFFFWFFWW
WWWFFWWWWFFFWWWWFFFFFFFFFFFFFWFFWW
WWWFFFFFFFFFFFWWFFFFFFFFFFFFFFFFWW
WWWFFFFTFFFFFFFFFFFFFFFFWWWWFRFFWW
WWWFFFFFFFFFFFFFFFFFFFFFFFFFFFFFWW
WWWWWWWWWWWWWWWWWWWWWWWWWWWWWWWWWW
WWWWWWWWWWWWWWWWWWWWWWWWWWWWWWWWWW
