WWWWWWWWWWWWWWWWWWWWWWWWWWWWWWWWWW
WWWWWWWWWWWWWWWWWWWWWWWWWWWWWWWWWW
WWFFFFFFFFFFFFFFFFFFFFFFFFFFFFFFWW
WWFFFFFFFFFFFFFFFFFFFFFFFFFFFFPFWW
WWFFFFFFFFFFFFFFFFFFFFFFFFFFFFFFWW
WWFFFWFFFWWWWWFFFWWWWWFFFWWWWWWWWW
WWFFFWFFFFFFFWFFFFFFFWFFFFFFFFFFWW
WWFFFWFFFFFRFWFFFFFRFWFFFFFFFFRFWW
WWFFFWFFFFFFFWFFFFFFFWFFFFFFFFFFWW
WWFFFWFFFWFFFWFFFWFFFWFFFWFFFFFFWW
WWFFFWFFFWFFFWFFFWFFFWFFFWFFFFFFWW
WWFFFWFFFWFFFWFFFWFFFWFFFWFFFFFFWW
WWFFFFFFFWFFFFFFFWFFFFFFFWFFFFFFWW
WWFFFFEFFWFFFFFEFWFFFFFEFWFEFFFFWW
WWFFFFFFFWFFFFFFFWFFFFFFFWFFFFFFWW
WWFFFWWWWWFFFWWWWWFFFWWWWWWWWFFFWW
WWFFFFFFFFFFFFFFFFFFFFFFFFFFFFFFWW
WWFFFFFEFFFFFFFEFFFFFFFFFEFFFFFFWW
WWFFFFFFFFFFFFFFFFFFFFFFFFFFFFFFWW
WWFFFFFFFFFFFFFFFFFFFFFFFFFFFFFFWW
WWFFFFFFFFMFFFFFFFFFFFMFFFFFFFFFWW
WWFFFFFFFFFFFFFFFFFFFFFFFFFFFFFFWW
WWFFWFFWFFWFFWFFWFFWFFWFFWFFWFFWWW
WWFFFFFFFFFFFFFFFFFFFFFFFFFFFFFFWW
WWFFFFFFFFFFFFFFFFFFFFFFFFFFFFFFWW
WWFFFFAFFAFFFAFFFAFFFAFFAFFFAFFFWW
WWFFFFFFFFFFFFFFFFFFFFFFFFFFFFFFWW
WWFFFFAFFFAFFFFMFFFMFFFAFFFAFFFFWW
WWFFFFFFFFFFFFFFFFFFFFFFFFFFFFFFWW
WWFFFFFFFFFFFFFFFFFFFFFFFFFFFFFFWW
WWFFFFAFFFAFFFAFFFAFFFAFFFAFFAFFWW
WWFFFFFFFFFFFFFFFFFFFFFFFFFFFFFFWW
WWWWWWWWWWWWWWWWWWWWWWWWWWWWWWWWWW
WWWWWWWWWWWWWWWWWWWWWWWWWWWWWWWWWW
