WWWWWWWWWWWWWWWWWWWWWWWWWWWWWWWWWW
WWWWWWWWWWWWWWWWWWWWWWWWWWWWWWWWWW
WWFFFFFFFFFFFFFFFFFFFFFFFFFFFFFFWW
WWFFFFAFFFAFFFAFFFAFFFAFFFAFFAFFWW
WWFFFFFFFFFFFFFFFFFFFFFFFFFFFFFFWW
WWFFFFFFFFFFFFFFFFFFFFFFFFFFFFFFWW
WWFFFFAFFFAFFFFMFFFMFFFAFFFAFFFFWW
WWFFFFFFFFFFFFFFFFFFFFFFFFFFFFFFWW
WWFFFFAFFAFFFAFFFAFFFAFFAFFFAFFFWW
WWFFFFFFFFFFFFFFFFFFFFFFFFFFFFFFWW
WWFFFFFFFFFFFFFFFFFFFFFFFFFFFFFFWW
WWFFWFFWFFWFFWFFWFFWFFWFFWFFWFFWWW
WWFFFFFFFFFFFFFFFFFFFFFFFFFFFFFFWW
WWFFFFFFFFMFFFFFFFFFFFMFFFFFFFFFWW
WWFFFFFFFFFFFFFFFFFFFFFFFFFFFFFFWW
WWFFFFFFFFFFFFFFFFFFFFFFFFFFFFFFWW
WWFFFFFEFFFFFFFEFFFFFFFFFEFFFFFFWW
WWFFFFFFFFFFFFFFFFFFFFFFFFFFFFFFWW
WWFFFWWWWWFFFWWWWWFFFWWWWWWWWFFFWW
WWFFFFFFFWFFFFFFFWFFFFFFFWFFFFFFWW
WWFFFFEFFWFFFFFEFWFFFFFEFWFEFFFFWW
WWFFFFFFFWFFFFFFFWFFFFFFFWFFFFFFWW
WWFFFWFFFWFFFWFFFWFFFWFFFWFFFFFFWW
WWFFFWFFFWFFFWFFFWFFFWFFFWFFFFFFWW
WWFFFWFFFWFFFWFFFWFFFWFFFWFFFFFFWW
WWFFFWFFFFFFFWFFFFFFFWFFFFFFFFFFWW
WWFFFWFFFFFRFWFFFFFRFWFFFFFFFFRFWW
WWFFFWFFFFFFFWFFFFFFFWFFFFFFFFFFWW
WWFFFWFFFWWWWWFFFWWWWWFFFWWWWWWWWW
WWFFFFFFFFFFFFFFFFFFFFFFFFFFFFFFWW
WWFFFFFFFFFFFFFFFFFFFFFFFFFFFFPFWW
WWFFFFFFFFFFFFFFFFFFFFFFFFFFFFFFWW
WWWWWWWWWWWWWWWWWWWWWWWWWWWWWWWWWW
WWWWWWWWWWWWWWWWWWWWWWWWWWWWWWWWWW
