WWWWWWWWWWWWWWWWWWWWWWWWWWWWWWWWWW
WWWWWWWWWWWWWWWWWWWWWWWWWWWWWWWWWW
WWFFFFFFFFFFFFFFFFFFFFFFFFFFFFFFWW
WWFPFFFFFFFFFFFFFFFFFFFFFFFFFFFFWW
WWFFFFFFFFFFFFFFFFFFFFFFFFFFFFFFWW
WWWWWWWWWFFFWWWWWFFFWWWWWFFFWFFFWW
WWFFFFFFFFFFWFFFFFFFWFFFFFFFWFFFWW
WWFRFFFFFFFFWFRFFFFFWFRFFFFFWFFFWW
WWFFFFFFFFFFWFFFFFFFWFFFFFFFWFFFWW
WWFFFFFFWFFFWFFFWFFFWFFFWFFFWFFFWW
WWFFFFFFWFFFWFFFWFFFWFFFWFFFWFFFWW
WWFFFFFFWFFFWFFFWFFFWFFFWFFFWFFFWW
WWFFFFFFWFFFFFFFWFFFFFFFWFFFFFFFWW
WWFFFFEFWFEFFFFFWFEFFFFFWFFEFFFFWW
WWFFFFFFWFFFFFFFWFFFFFFFWFFFFFFFWW
WWFFFWWWWWWWWFFFWWWWWFFFWWWWWFFFWW
WWFFFFFFFFFFFFFFFFFFFFFFFFFFFFFFWW
WWFFFFFFEFFFFFFFFFEFFFFFFFEFFFFFWW
WWFFFFFFFFFFFFFFFFFFFFFFFFFFFFFFWW
WWFFFFFFFFFFFFFFFFFFFFFFFFFFFFFFWW
WWFFFFFFFFFMFFFFFFFFFFFMFFFFFFFFWW
WWFFFFFFFFFFFFFFFFFFFFFFFFFFFFFFWW
WWWFFWFFWFFWFFWFFWFFWFFWFFWFFWFFWW
WWFFFFFFFFFFFFFFFFFFFFFFFFFFFFFFWW
WWFFFFFFFFFFFFFFFFFFFFFFFFFFFFFFWW
WWFFFAFFFAFFAFFFAFFFAFFFAFFAFFFFWW
WWFFFFFFFFFFFFFFFFFFFFFFFFFFFFFFWW
WWFFFFAFFFAFFFMFFFMFFFFAFFFAFFFFWW
WWFFFFFFFFFFFFFFFFFFFFFFFFFFFFFFWW
WWFFFFFFFFFFFFFFFFFFFFFFFFFFFFFFWW
WWFFAFFAFFFAFFFAFFFAFFFAFFFAFFFFWW
WWFFFFFFFFFFFFFFFFFFFFFFFFFFFFFFWW
WWWWWWWWWWWWWWWWWWWWWWWWWWWWWWWWWW
WWWWWWWWWWWWWWWWWWWWWWWWWWWWWWWWWW
